12 12 30 15
S 0 0 3 -1 0 0 0 -1 0 0 0
0 0 1 0 -1 0 0 0 F1 0 -1 0
0 -1 -1 0 0 0 2 0 0 0 0 0
F1 0 0 -1 0 0 0 -1 0 0 0 0
0 0 0 -1 0 0 0 8 3 0 -1 0
0 0 0 0 0 1 -1 0 0 0 2 -1
0 0 0 0 -1 0 0 -1 5 0 0 0
-1 0 0 0 0 0 0 0 0 -1 0 3
0 0 0 -1 0 0 -1 0 0 0 0 0
0 -1 0 0 0 3 0 0 2 -1 0 0
0 0 F1 0 -1 0 F1 0 0 0 0 0
0 0 3 0 0 -1 0 0 1 0 0 G