13 13 26
S 0 0 -1 0 0 -1 0 -1 0 0 0 0
0 -1 3 0 0 -1 0 -1 0 0 0 -1 -1
1 0 0 0 -1 0 0 0 0 0 -1 0 0
0 -1 0 0 0 0 0 -1 0 0 0 0 -1
-1 0 0 -1 0 0 0 -1 0 0 0 0 0
0 0 0 -1 0 0 0 3 0 0 -1 0 -1
0 0 -1 0 0 0 -1 0 0 0 0 -1 0
0 0 0 0 -1 0 0 -1 0 0 0 0 -1
-1 0 0 0 0 0 0 0 0 -1 0 0 -1
0 0 0 -1 0 0 -1 0 0 0 0 0 0
0 -1 0 0 0 0 -1 0 0 -1 4 0 -1
0 0 0 0 -1 0 0 0 0 0 0 0 -1
-1 0 0 0 0 -1 0 0 3 0 0 0 G