10
G.-.W.-.-.-.B.-.-.-
-.-.-.G.-.-.P.G.-.-
-.-.-.-.G.-.-.-.-.-
-.W.-.-.-.-.P_G.-.-.-
-.G.-.-.-.W.-.P.-.-
-.-.G.-.-.-.-.-.-.-
G.-.-.-.G.-.-.-.-.-
-.-.-.W.-.-.-.-.P.-
-.-.-.-.-.H_P.-.-.-.-
-.-.-.-.-.G.-.-.-.-
