10
G.-.W.-.-.-.-.-.-.-
-.-.-.G.-.-.P.G.-.-
-.-.-.-.G.-.-.-.-.-
-.W.-.-.-.-.-.-.-.-
-.G.-.-.-.W.-.P.-.-
-.-.G.-.-.-.-.-.-.-
G.-.-.-.G.-.-.-.-.-
-.-.-.W.-.-.-.-.P.-
G.G.-.-.-.P_G.-.-.-.-
-.-.-.-.-.G.-.-.H_P.-