10
-.-.-.-.P.-.-.-.-.-
-.-.G.-.-.W.-.-.-.-
P.-.-.W.-.-.-.G.-.-
-.-.-.-.-.H_P.-.-.-.-
-.-.P.-.-.-.-.-.-.G
-.P_G.-.-.-.-.-.-.-.-
-.-.-.-.-.G.-.-.W.-
-.-.-.-.H_P.-.-.-.-.-
-.-.-.-.-.-.-.-.-.-
-.-.G.-.-.-.-.P.-.-