10
-.-.-.-.-.-.-.-.-.-
-.-.w.-.-.-.p.-.-.-
-.-.-.-.-.-.-.-.-.-
P_G.-.-.-.G.-.-.-.-.-
-.-.-.-.P.-.-.-.W.-
-.-.-.-.-.-.-.-.-.-
-.G.-.-.-.P.-.-.-.-
-.-.-.H_P.-.-.-.P_G.-.-
-.-.-.-.-.-.-.-.-.-
-.-.-.-.W.-.-.-.-.-