10
-.-.-.G.-.-.-.W.-.-
-.-.-.-.-.-.-.-.P.-
-.-.P_G.-.-.-.-.-.-.-
G.-.-.-.-.P.-.-.-.-
-.-.W.-.-.-.-.-.-.W
-.-.-.-.-.-.-.-.-.-
-.-.-.-.-.-.P_G.-.-.-
-.-.-.-.-.-.-.-.-.-
-.-.G.-.-.-.-.P.P.-
-.-.-.-.-.-.-.-.-.-