10
-.-.-.-.-.-.-.-.-.-
-.-.-.P.-.-.-.W.-.-
-.-.-.-.-.H_P.-.-.-.W
G.-.-.-.-.-.-.-.-.-
-.-.-.-.-.-.P.-.-.-
-.W.-.-.-.W.-.-.-.-
-.-.-.G.-.-.-.-.P.-
P.-.-.-.-.-.-.-.-.-
-.-.-.-.-.W.-.-.-.-
-.-.-.P.-.-.-.-.-.-