14 14 30
S 0 0 -1 0 0 -1 0 -1 0 0 0 0 0
0 -1 4 0 0 -1 0 -1 0 0 0 -1 -1 0
0 0 0 0 -1 0 0 0 0 0 -1 0 0 -1
0 -1 0 0 0 0 0 -1 0 0 0 3 -1 0
-1 0 0 -1 0 0 0 -1 0 0 0 0 0 -1
0 0 0 -1 0 0 0 0 0 0 -1 0 -1 0
-1 0 0 0 -1 0 0 -1 0 0 0 0 0 -1
0 0 -1 0 0 0 -1 0 0 0 0 -1 0 -1
0 0 0 0 -1 0 0 -1 0 0 0 0 -1 0
-1 0 0 0 0 2 0 0 0 -1 0 6 -1 0
0 0 0 -1 0 0 -1 0 0 0 0 0 0 0
0 -1 0 0 0 0 -1 0 0 -1 0 0 -1 0
0 0 0 0 -1 0 0 0 0 0 0 0 -1 0
-1 0 0 0 0 -1 0 0 0 0 0 0 G 0
