12 12 25
S 0 0 3 -1 0 0 0 -1 0 0 0
0 0 1 0 -1 0 0 0 0 0 -1 0
0 -1 -1 0 0 0 2 0 0 0 0 0
0 0 0 -1 0 0 0 -1 0 0 0 0
0 0 0 -1 0 0 0 8 3 0 -1 0
0 0 0 0 0 1 -1 0 0 0 2 -1
0 0 0 0 -1 0 0 -1 5 0 0 0
-1 0 0 0 0 0 0 0 0 -1 0 3
0 0 0 -1 0 0 -1 0 0 0 0 0
0 -1 0 0 0 3 0 0 2 -1 0 0
0 0 0 0 -1 0 0 0 0 0 0 0
0 0 3 0 0 -1 0 0 1 0 0 G