13 13 40 20
S 0 0 -1 0 0 -1 0 -1 0 0 0 0
0 -1 3 0 0 -1 0 -1 0 0 0 -1 -1
1 0 0 0 -1 0 0 F1 0 0 -1 0 0
0 -1 0 0 0 0 0 -1 0 F1 0 0 -1
-1 0 0 -1 0 0 0 -1 0 0 0 0 0
0 0 0 -1 0 0 0 3 0 0 -1 0 -1
0 0 -1 0 0 0 -1 0 0 0 0 -1 0
0 0 0 0 -1 0 0 -1 0 0 F1 0 -1
-1 0 0 F1 0 0 0 0 0 -1 0 0 -1
0 0 0 -1 0 0 -1 0 0 0 0 0 0
0 -1 0 0 0 0 -1 0 0 -1 4 0 -1
0 0 0 0 -1 0 0 0 0 0 0 0 -1
-1 0 0 0 0 -1 0 0 3 0 0 0 G