11 11 25
S 0 0 5 0 -1 -1 0 0 0 0
0 -1 -1 0 -1 0 0 0 -1 -1 0
0 -1 0 0 0 0 -1 0 0 0 0
0 -1 0 0 0 -1 0 -1 0 0 0
0 2 0 -1 0 0 -1 0 0 -1 0
-1 -1 0 0 0 -1 -1 0 0 -1 0
0 0 0 -1 0 0 0 6 0 -1 0
0 -1 0 -1 -1 -1 -1 0 G 0 0
0 -1 0 0 1 0 -1 0 0 -1 0
0 0 0 -1 0 0 0 0 0 0 0
0 -1 0 -1 0 0 -1 0 0 0 -1